[
["#","#","#",".","#","#","#","#","#","#"," "," "," "," "," "," "," "," "," "," "," "," "," "," "," "," "," "," "," "," ","#","#","#","#","#","#","#","#","#","#","#"],
["#","@",".",".","w",".","h",".","e","#","#","#","#","#","#","#","#","#","#","#","#","#","#","#","#","#","#","#","#","#","#",".",".",".",".","e",".",".",".","e","#"],
["#","k",".",".","^",".","b",".",".","?",".",".",".",".",".",".","G",".",".",".",".",".",".","e",".",".",".",".",".",".","-",".",".",".","#","#","#","#","#",".","#"],
["#",".","m",".","S",".","p","p","o","#","#","#","#","#","#","#","#","#","#","#","#","#","#","#","#","-","#","#","#","#","#",".",".",".",".","S",".",".","#",".","#"],
["#",".",".",".",".",".",".",".","X","#",".",".",".",".",".",".","#"," "," "," ","#",".",".","G",".",".",".","#"," "," ","#",".",".",".","#","e",".","?","#",".","#"],
["#",".",".",".","k",".",".",".",".","#",".",".",".",".",".",".","#"," "," "," ","#",".",".","G",".",".",".","#"," "," ","#",".",".",".","#","e",".","?","#",".","#"],
["#",".",".",".","e",".",".","p",".","#",".",".",".",".",".",".","#"," "," "," ","#",".",".","G",".",".",".","#"," "," ","#",".",".",".","#","e",".","?","#",".","#"],
["#","#","#","#","#","-","#","#","#","#",".",".",".",".",".",".","#"," "," "," ","#",".",".","G",".",".",".","#"," "," ","#",".",".",".","#","e",".","?","#",".","#"],
["#",".",".",".","X",".",".",".","X",".",".",".",".",".",".",".","#","#","#","#","#","#",".",".",".",".",".","#"," "," ","#",".","G",".","#","#","#","#","#",".","#"],
["#",".",".",".",".",".","p",".",".",".",".",".",".",".",".",".",".",".",".",".",".","?",".",".",".",".",".","#"," "," ","#",".",".",".",".",".",".",".",".",".","#"],
["#",".",".",".",".",".","p",".",".",".",".",".",".",".",".",".","#","#","#","#","#",".","?",".",".",".",".","#"," "," ","#",".",".",".",".",".",".",".",".",".","#"],
["#",".",".",".",".",".",".",".",".",".",".",".",".",".",".",".","#"," "," "," ","#",".","?",".",".",".",".","#"," "," ","#",".",".",".",".",".",".",".",".",".","#"],
["#",".",".","h",".",".","h","h","h",".",".",".",".",".",".",".","#"," "," "," ","#",".","?",".",".",".",".","#"," "," ","#",".",".",".",".",".",".",".",".",".","#"],
["#",".",".","h",".",".","h","h","h",".",".",".",".",".",".",".","#"," "," "," ","#",".","?",".",".",".",".","#"," "," ","#",".",".",".",".",".",".",".",".",".","#"],
["#","#","#","#","#","#","#","#","#","#","#","#","#","#","#","#","#","#","#","#","#","#","#","#","#","#","#","#","#","#","#","#","#","#","#","#","#","#","#","#","#"]
]