################
#..............#
#..............#
#..............#
#..............#
################