{
  [
'#','#','#','.','#','#','#'###                    ###########
'#','@','.','.','w','.','h'.e######################....e...e#
'#','.','.','.','^','.','b'..?......G......e......-...#####.#
'#','.','m','.','S','.','p'po################-#####....S..#.#
'#','.','.','.','.','.','.'..#......#   #..G...#  #...#e.?#.#
'#','.','.','.','.','.','.'..#......#   #..G...#  #...#e.?#.#
'#','.','.','.','.','.','.'..#......#   #..G...#  #...#e.?#.#
'#','#','#','#','#','#','#'###......#   #..G...#  #...#e.?#.#
'#','.','.','.','X','.','.'.X.......######.....#  #.G.#####.#
'#','.','.','.','.','.','.'..............?.....#  #.........#
'#','.','.','.','.','.','.'.........#####.?....#  #.........#
'#','.','.','.','.','.','.'.........#   #.?....#  #.........#
'#','.','.','h','.','.','h'hh.......#   #.?....#  #.........#
'#','.','.','h','.','.','h'hh.......#   #.?....#  #.........#
'#','#','#','#','#','#','#'##################################
]
}