###.######                    ###########
#@..w.h.e######################....e...e#
#...^.b..?......G......e......-...#####.#
#.m.S.ppo################-#####....S..#.#
##########.......#   #..G..#  #...#e.?#.#
  #..X...X.......#   #.....#  #.G.#####.#
  #..............#   #.?...#  #.........#
  #..............#   #.?...#  #.........#
  #..............#   #.?...#  #.........#
  #.h..hhh.......#   #######  ###########
  #.h..hhh.......#
  ################