###.######                    ###########
#@..w.h.e######################....e...e#
#...^.b..?......G......e......-...#####.#
#.m.S.ppo################-#####....S..#.#
#.......X#......#   #..G...#  #...#e.?#.#
#........#......#   #..G...#  #...#e.?#.#
#........#......#   #..G...#  #...#e.?#.#
#####-####......#   #..G...#  #...#e.?#.#
#...X...X.......######.....#  #.G.#####.#
#.....p..............?.....#  #.........#
#.....p.........#####.?....#  #.........#
#...............#   #.?....#  #.........#
#..h..hhh.......#   #.?....#  #.........#
#..h..hhh.......#   #.?....#  #.........#
#########################################