###.######                    ###########
#@..w.h.e######################....e...e#
#...^.b..?......G......e......-...#####.#
#.m.S.ppo################-#####....S..#.#
#........#......#   #..G...#  #...#e.?#.#
#........#......#   #..G...#  #...#e.?#.#
#........#......#   #..G...#  #...#e.?#.#
##########......#   #..G...#  #...#e.?#.#
#...X...X.......######.....#  #.G.#####.#
#....................?.....#  #.........#
#...............#####.?....#  #.........#
#...............#   #.?....#  #.........#
#..h..hhh.......#   #.?....#  #.........#
#..h..hhh.......#   #.?....#  #.........#
#########################################